NO src/xpm/t4.xpm
SO src/xpm/t4.xpm
WE src/xpm/t4.xpm
EA src/xpm/t4.xpm

F 60,200,19
C 255,200,100


1111111111111111111111111
1000000000000000000000001
1000000000000000000000001
1000000000000000000000001
1000000000111110000000001
1000000000000000000000001
1000000000000000000000001
1000000000000000000000001
100000000000N000000000001
1000000000000000000000001
1000000000000000000000001
1000000000000000000000001
1000000000000000000000001
1000000000000000000000001
1000000000000000000000001
1000000000000000000000001
1000000000000000000000001
1000000000000000000000001
1111111111111111111111111

